1111111111111
1000110001011
101P11C1010E1
1000000100011
1111111111111
