11111111111111111111111111111111
1P0000001C0000000000000000000001
11111110111111111100000E00000001
11111110000000000000000000001101
1C000000111110000000000111110001
10000011101111111000000000000011
11111111111101111000000000000001
1C000000000000000000000000000001
11111111111111111111111111111111
